
C    20,20,20
F    20,15,25
NO      ./src/textures/wall1.xpm 

SO      ./src/textures/wall3.xpm
EA      ./src/textures/wall4.xpm

WE      ./src/textures/wall2.xpm	



   1111
   1001 1111111111111111111111111
   1001 1000000000110000000000001
   1111 1011000001110000000000001
        1001000000000000000000001
111111111011000001110000000000001
100000000011000001110111110111111
11110111111111011100000010001
11110111111111011101010010001
11000000110101011100000010001  
10000000000000001100000010001
10000000000000001101010010001
110000011101010111110111100011
11110111 1110101 1011110100N01
11111111 1111111 1111111111111
111111111111111111111111111111



