


NO      ./src/textures/wall1.xpm
WE      ./src/textures/wall2.xpm
SO      ./src/textures/wall3.xpm
EA      ./src/textures/wall4.xpm

C    5,5,4
F    20,20,20
		

   111
   111  1111111111111111111111111
   101  10000N0000110000000000001
   111  1011000001110000000000001
        1001000000000000000000001
111111111011000001110000000000001
100000000011000001110111111111111
11110111111111011100000010001
11110111111111011101010010001
11000000110101011100000010001  
10000000000000001100000010001
10000000000000001101010010001
110000011101010111110111100011
11110111 1110101 1011110100001
11111111 1111111 1111111111111      111111
                                    111001
                                    100001
                                    111111
    




