NO      ./textures/Vinelike_Pattern_64x64.png

SO      ./textures/Brick_Wall_Cracked_64x64.png
EA      ./textures/Rocky_Road_64x64.png

WE      ./textures/Wooden_Floor_Vertical_64x64.png

F    0,20,180
C    5,150,5

  111111
  100001
  10001
  1001     1111111111111111111111111
  1001     1000000000110000000000001
  1111     1011000001110000000000001
           1001000000000000000000001
  111111111011000001110000000000001
  100000000011000001110111111111111
  11110111111111011100000010001
  11110111111111011101010010001
  11000000110101011100000010001
  10000000000000001100000010001
  10000000000000001101010010001
  110S0001110101011111011110001
  11111111 1111111 111111011111
  11111111 1111111 111111111111
