	  	NO   	./textures/wall2.xpm
	WE      ./textures/wall2.xpm
SO      textures/star4.xpm
EA      textures/star3.xpm
		 
F    20,20,20
	C    5,5,5     		   
   
	    
		   
    		   
01111111111111111111111111
 10000000110000000000001
        1011000001110000000000001
        1001000000000000000000001
111111111011000001110000000000001
100000000011000001110111111111111
11110111111111011100000010001
11110111111111011101010010001
11000000110101011100000010001
10000000000000001100000010001
1000000P000000110101001001
1100000111010101111101111000111
11110111 1110101 101111010000001
11111111 1111111 1111111111111101



				   
				   	  
					  

