C    20,5,20

NO      ./src/textures/wall1.xpm

SO      ./src/textures/wall3.xpm
EA      ./src/textures/wall4.xpm



F    20,20,20
	WE      ./src/textures/wall2.xpm	

        1111111111 11111111111111
        1000000001110000000000001
        1011000001110000000000001
        1001000000000000000000001
111111111011000001110000000000001
100000000011000001110111111111111
11110111111111011100000010001
111101111111110111010100100011111111111111111111111111111111111
100000000000000000000000000000000000000000000000000000000000001
110000000000000011010100100011111111111000000000000000N00000011
 100000111010101111101111000111       1000000000000000000000001
11110111 1110101 111011110001         1000000000000000000000001
11111111 1111111 111011111111         1111111111111100000001111
        1111111111 10111111111111                  100000001
        10000000011100000000000011111111111111     100010001
        10110000011100000000000000000000000001     100000001
        10010000000000000000000000000000000001     100000001
1111111110110000011100000000000010000000000001     100010001
1000000000110000011100111111111111111111111111     100000001
11110111111111011100000010001                      100000001
111101111111110111010100100011111111111111111111111111000101111
100000000000000000000000000000000000000000000000000000000000001
110000000000000011010100100011111111111111111111111111000111001
 100000101010101110101111000111                      1000111001
11110111011101011101111010001                        1000000001
11111111011111111101111111111                        1000000001
    1000011111111101111111111111111                  1000100001
    10111110000000011100000000000011111              1000000001
    10111110010011000000100000010000001111111111111111111011111
    1011111001000000000010000001000000000000000000000000001
    1011111001001100000010000001000000111111111111111111111
    11111111111111111111111111111111111